SpawnLocations: 0,0; 12,0; 25,0
Tanks: 6, 6, 6, 6, 6, 7, 6, 6, 6, 6, 6, 6, 6, 7, 6, 6, 6, 6, 6, 6
0,0,0,0,0,0,0,0,0,0,0,0,0,0,0,0,0,0,0,0,0,0,0,0,0,0
0,0,0,0,0,0,0,0,0,0,0,0,0,0,0,0,0,0,0,0,0,0,0,0,0,0
0,0,0,0,0,0,0,0,1,1,0,0,1,1,0,0,0,0,0,0,0,0,0,0,0,0
0,0,0,0,0,0,0,0,1,1,0,0,1,1,0,0,0,0,0,0,0,0,0,0,0,0
2,2,0,0,0,0,2,2,1,1,2,2,1,1,2,2,0,0,0,0,2,2,0,0,0,0
2,2,0,0,0,0,2,2,1,1,2,2,1,1,2,2,0,0,0,0,2,2,0,0,0,0
1,1,2,2,2,2,1,1,1,1,1,1,1,1,1,1,2,2,2,2,1,1,2,2,0,0
1,1,2,2,2,2,1,1,1,1,1,1,1,1,1,1,2,2,2,2,1,1,2,2,0,0
1,1,1,1,1,1,1,1,4,4,1,1,4,4,1,1,1,1,1,1,1,1,2,2,0,0
1,1,1,1,1,1,1,1,4,4,1,1,4,4,1,1,1,1,1,1,1,1,2,2,0,0
3,3,3,3,12,0,12,0,1,1,1,1,1,1,1,1,3,3,3,3,3,3,2,2,0,0
3,3,3,3,0,0,0,0,1,1,1,1,1,1,1,1,3,3,3,3,3,3,2,2,0,0
3,3,1,1,12,0,1,1,1,1,1,1,1,1,1,1,1,1,1,1,3,3,3,3,2,2
3,3,1,1,0,0,1,1,1,1,1,1,1,1,1,1,1,1,1,1,3,3,3,3,2,2
1,1,1,1,1,1,3,3,1,1,1,1,1,1,3,3,1,1,1,1,1,1,2,2,2,2
1,1,1,1,1,1,3,3,1,1,1,1,1,1,3,3,1,1,1,1,1,1,2,2,2,2
1,1,1,1,3,3,3,3,3,3,1,1,3,3,3,3,3,3,1,1,1,1,3,3,3,3
1,1,1,1,3,3,3,3,3,3,1,1,3,3,3,3,3,3,1,1,1,1,3,3,3,3
2,2,3,3,3,3,2,2,2,2,2,2,2,2,2,2,3,3,3,3,2,2,3,3,2,2
2,2,3,3,3,3,2,2,2,2,2,2,2,2,2,2,3,3,3,3,2,2,3,3,2,2
0,0,2,2,2,2,12,0,12,0,0,0,0,0,0,0,2,2,2,2,0,0,2,2,0,0
0,0,2,2,2,2,0,0,0,0,0,0,0,0,0,0,2,2,2,2,0,0,2,2,0,0
13,0,13,0,0,0,0,0,0,0,0,0,0,0,0,0,0,0,0,0,0,0,0,0,0,0
0,0,0,0,0,0,0,0,0,0,0,0,0,0,0,0,0,0,0,0,0,0,0,0,0,0
13,0,13,0,0,0,0,0,5,0,0,0,10,0,0,0,0,0,0,0,0,0,0,0,0,0
0,0,0,0,0,0,0,0,0,0,0,0,0,0,0,0,0,0,0,0,0,0,0,0,0,0