SpawnLocations: 0,0; 12,0; 25,0
Tanks: 6, 6, 6, 6, 6, 7, 6, 6, 6, 6, 6, 6, 6, 7, 6, 6, 6, 6, 6, 6
0,0,0,0,0,0,0,0,0,0,0,0,0,0,0,0,0,0,0,0,0,0,0,0,0,0
0,0,0,0,0,0,0,0,1,1,0,0,0,0,0,0,0,0,0,0,1,1,0,0,0,0
0,0,1,1,0,0,1,1,1,1,0,0,0,0,11,11,11,11,11,11,1,1,1,1,0,0
0,0,1,1,0,0,1,1,1,1,0,0,0,0,11,11,11,11,11,11,1,1,1,1,0,0
0,0,1,1,0,0,0,0,1,1,0,0,4,4,11,11,11,11,11,11,11,11,11,11,0,0
0,0,1,1,0,0,0,0,1,1,0,0,4,4,11,11,11,11,11,11,11,11,11,11,0,0
11,11,11,11,11,11,4,0,1,1,0,0,0,0,1,1,11,11,11,11,11,11,11,11,0,0
11,11,11,11,11,11,4,0,1,1,0,0,0,0,1,1,11,11,11,11,11,11,11,11,0,0
11,11,11,11,11,11,11,11,11,11,11,11,1,1,1,1,0,1,1,0,0,0,0,0,0,0
11,11,11,11,11,11,11,11,11,11,11,11,1,1,1,1,0,1,1,0,0,0,0,0,0,0
0,0,0,0,0,4,11,11,11,11,11,11,11,11,1,1,0,1,1,0,0,0,4,4,4,4
0,0,0,0,0,4,11,11,11,11,11,11,11,11,1,1,0,1,1,0,0,0,0,0,0,0
1,1,1,1,1,1,1,1,11,11,11,11,11,11,11,11,11,11,11,11,11,11,1,1,1,1
1,1,1,1,1,1,1,1,11,11,11,11,11,11,11,11,11,11,11,11,11,11,1,1,1,1
0,0,0,0,0,0,1,1,1,1,11,11,11,11,11,11,11,11,4,0,0,0,0,0,0,0
0,0,0,0,0,0,1,1,1,1,11,11,11,11,11,11,11,11,4,0,0,0,0,0,0,0
0,0,1,1,1,1,1,1,0,0,11,11,11,11,11,11,1,1,1,1,0,0,1,1,0,0
0,0,1,1,1,1,1,1,0,0,11,11,11,11,11,11,1,1,1,1,0,0,1,1,0,0
11,11,11,11,11,11,1,1,11,11,0,0,0,0,0,0,0,0,1,1,0,0,1,1,0,0
11,11,11,11,11,11,1,1,11,11,0,0,0,0,0,0,0,0,1,1,0,0,1,1,0,0
11,11,11,11,11,11,11,11,11,11,4,4,0,0,4,4,0,0,0,0,0,0,1,1,0,0
11,11,11,11,11,11,11,11,11,11,0,0,0,0,0,0,0,0,0,0,1,1,1,1,0,0
1,1,11,11,11,11,11,11,11,11,0,0,0,0,0,0,0,0,1,1,0,0,0,0,0,0
1,1,11,11,11,11,11,11,11,11,0,0,0,0,0,0,0,0,1,1,0,0,0,0,0,0
1,1,1,1,4,0,0,0,5,0,0,0,10,0,0,0,0,0,1,1,0,0,1,1,0,0
1,1,1,1,4,0,0,0,0,0,0,0,0,0,0,0,0,0,1,1,0,0,1,1,0,0